111111111
122222221
122222231
122222111
122222221
111111111

1,1
7,4