111111111
12222222111111
12222222222231
12222211111111
122222221
111111111

1,1
7,4